075 -> ycywmnum
tabs -> ltqquaoa
num -> rjinbyhl
text-muted -> tidyviuy
img-responsive -> sdhumscf
stui-header__logo -> bksarldq
form-control -> pcixbhyz
more -> cnhmvbxd
partialViewSlider-nav -> iufawcql
list_type_title -> fuqkwews
98 -> hhlmmbyy
container -> vvdelcbx
pl-box-r -> jlmygvzp
embed-responsive -> abwvtadm
2s -> hesvyolk
info-icon -> gpxhcxti
3s -> frabubbc
dialog-overlay -> tvzniqbf
6666667 -> xlauokvl
embed-responsive-16by9 -> ypoakowf
stui-header__menu -> rvtqcwar
partialViewSlider-next -> znipmcte
info-text -> whmysuoj
t-ul -> afxfpuik
hidden-xs -> wljxtsac
title -> ugmxrezq
hidden-lg -> gydheszk
text-center -> dnapxmio
hidden-md -> xhfgmxqy
fl-l -> toiiogfx
partialViewSlider-prev -> gdbahwml
8 -> kvevvsrv
partialViewSlider-neighborControls -> pcdojmgx
text -> bxenxldy
dialog-content-title -> qhvrvumi
dialog-wrap-info -> dziexxyc
stui-screen__list -> sgodohlx
25s -> rbdxvvxe
stui-pannel-side -> flkbjqcs
dialog-btn-ok -> zossyzsi
page-item -> yhhwgjau
partialViewSlider-wrapper -> trpeaydz
1 -> jalhtkdx
data -> pkknnejl
dw-t -> spgdomqj
visible-lg -> epadnsxw
partialViewSlider-outsideControls -> jvstiqaj
stui-content__ad -> jpffzews
pagego -> adhofiqu
sx-title2 -> preoxoja
button -> kytwgfmc
sx-title -> jysouiyf
pl-r -> emujccyf
dialog-content-ft -> dltdcmpa
dialog-btn-cancel -> laguicmf
dialog-wrap-show -> ndbjgscv
material-icons -> botrxkoa
visible-xs -> lqlhntxk
visible-md -> klvjetat
pagebtn -> wttoefzz
dialog-content -> seomvaqh
15s -> aespgqaf
pagenow -> sunfnovl
333333 -> tasjjrlu
split-line -> wmljrlcq
stui-content__playlist -> kcsijzbw
pic-text -> tvwuhfil
margin-0 -> cpeekxew
stui-player -> pskwyiyh
desc -> rezyxrqn
dialog-content-hd -> ypzxhokv
hidden-sm -> xatsgjti
ms-p -> uczmpscq
4 -> shmqxfrj
visible-sm -> sboahzkk
stui-foot -> xzxlxwpt
hide -> kuljnazc
stui-content__desc -> eclpxayb
embed-responsive-item -> mxuksvdw
stui-header__top -> guabtoaz
stui-vodlist__title -> gvwlwtkq
fo-t -> tsyadiwl
col-pd -> jeyofxkw
letter-list -> kfujbost
pl-box -> tragmkmm
disabled -> dlrhqrqx
padding-0 -> oppjofqk
logo -> hwapfiqy
25 -> tlnsxtls
stui-page -> enpoaeua
playbtn -> wjrsxbeu
png -> ttambqmk
5 -> tnmrdctq
stui-pannel__head -> kikpawpu
stui-vodlist__item -> gwgdkykh
pl-l -> pcckzltk
pull-left -> ywyyfgxx
pull-right -> xkwfoilz
wx-bg -> gjefhisb
zt-b -> luyqwihs
embed-responsive-4by3 -> ehapoczq
img-xs -> xoglsafd
stui-header__type -> xwuyukhu
partialViewSlider-outerwrapper -> jdhnvxqw
stui-pannel -> prvvbktp
stui-page-text -> grpuiqfr
666666 -> fynxcrbd
stui-header__search -> pqjeierq
partialViewSlider-perspective -> lhtrzhyq
stui-content__thumb -> vnuwnotk
foornav -> yiozgyri
ad-b -> okcuibfj
stui-player__video -> qdgaqwts
stui-vodlist__thumb -> hpnothjy
submit -> uewicwue
MacPlayer -> qrznqkml
stui-pannel-left -> muqtiyre
text-red -> upgbmsps
dialog-content-bd -> glovtcnb
stui-link__text -> hoggjfun
6 -> dboxznar
stui-page__box -> glocaivp
pic -> kaubxoaj
stui-header__user -> bjyimxiw
partialViewSlider-right -> amucjhnk
no-b -> zsbyakqh
dropdown -> nsdqwtiv
stui-news-nav -> nbsvnnev
clearfix -> xbhcwglg
partialViewSlider-backdrop -> pmdoguxh
o-bg -> izdsyomp
fenlei -> xybgixmk
visible-mi -> jnfapqns
stui-content__detail -> wxpnypys
row -> lzyronyu
fo-t1 -> hnriuffr
content -> wsfcqabi
svg -> jkkuqmhg
video-title -> edocbqea
type-list-fl -> hrwuczmn
fl-r -> jkklnuie
dialog-content-info -> asspzvli
sx-no -> sddyavyv
pl-in -> malcmbij
partialViewSlider-dots -> moqdkrxz
play -> lrwcxrsd
left -> ywexlbzz
